WWWWWWWWWWWWW
W---SSS----SW
W--P-----SWWWWWWWWWWWWWWWWWWWWWWWWWW
W--------SSWWWWWWWWWWWWWWWWWWW-----W
W-------------------------------W--W
W-------------------------------W-SW
W-------------------------------WS-W
W-------------------------------W-SW
W-------------------------------WS-W
W-------------------------------W-SW
W-------------------------------W-GW
