WWWWWWWWWWWWW
W---SSS----SW
W--P-----SWWW
W--------SSGW
WWWWWWWWWWWWW