WWWWWWW
W-----W
W--PWWW
W---WGW
WWWWWWW