W-SPW
W---W
WS--W
W--SW
W--SW
W---W
W---W
W-S-W
W---W
W-S-----------GW
W---W
W--sW
W---W
W---W
W---W
W-S-W
W---W